alanus = Alain Le Marchand <AlanUS.forum@gmail.com>
alfredos = Alfredo Sola <alfredo@sola.es>
bhoffman351 = Brett Hoffman <bhoffman351@mac.com>
billchown = Bill Chown <orrrbrit2004@yahoo.com>
bob-m-dcc = Bob Milhaupt <devel-bobm@sbcglobal.net>
crosland = Andrew Crosland <andrewcrosland@talktalk.net>
dan_boudreau = Dan Boudreau <dan_boudreau@users.sourceforge.net>
dat7719 = Dale A. Tripp <dat7719@users.sourceforge.net>
davefalkenburg = Dave Falkenburg <davefalkenburg@users.sourceforge.net>
dheap = Dave Heap <dgheap@gmail.com>
djduchamp = Dave Duchamp <djduchamp@users.sourceforge.net>
enzofortuna = Enzo Fortuna <fortuna.enzo@gmail.com>
ginsburg = Gregory Madsen <ginsburg@users.sourceforge.net>
giorgioitaly = Giorgio Terdina <giorgioitaly@users.sourceforge.net>
glenobie = Glen Oberhauser <glenobie@users.sourceforge.net>
gmadsen = Gregory Madsen <gmadsen@users.sourceforge.net>
hebbos = Lionel Jeanson <hebbos@users.sourceforge.net>
innkeeper = Howard G. Penny <innkeeper@users.sourceforge.net>
jacobsen = Bob Jacobsen <jacobsen@mac.com>
john_harper = John Harper <john_harper@users.sourceforge.net>
ken_c = Ken Cameron <kcameron@twcny.rr.com>
kevin-dickerson = Kevin Dickerson <kev.public@ntlworld.com>
kiwi64ajs = Alex Shepherd <kiwi64ajs@gmail.com>
matthewharris = Matthew Harris <matthew.john.harris@gmail.com>
mdavison = mdavison <mdavison@users.sourceforge.net>
millerdl = Dennis Miller <millerdl@telusplanet.net>
mstevetodd = Steve Todd <mstevetodd@mstevetodd.com>
(no author) = Bob Jacobsen <jacobsen@mac.com>
nratonpass = Tim Hatch <nratonpass@users.sourceforge.net>
pbender = Paul Bender <paul.bender@acm.org>
pete_cressman = Pete Cressman <pete_cressman@sbcglobal.net>
pinkrdp = Ronnie Pinkerton <pinkrdp@users.sourceforge.net>
plocher = John Plocher <john.plocher@gmail.com>
prfraker = prfraker <prfraker@users.sourceforge.net>
r5gordini = Andrew Berridge <r5gordini@users.sourceforge.net>
rcoleman = Robert (Bob) Coleman <rcoleman@users.sourceforge.net>
rhwood = Randall Wood <randall.h.wood@alexandriasoftware.com>
root = Bob Jacobsen <jacobsen@mac.com>
rscheffler = Robert Scheffler <rscheffler@users.sourceforge.net>
twindad = Mark Underwood <msunderwd@gmail.com>
uid282776 = Ken Cameron <kcameron@twcny.rr.com>
uid52720 = Bob Jacobsen <jacobsen@mac.com>
wsb56 = Bernd Wisotzki <ba@modellbahn.wisotzki.org>
zoo = david d zuhn <zoo@statebeltrailway.org>
trstack = Tom Stack <trstack@earthlink.net>
